0 0 0 0 0 0 0 0 0 0 0 0 0 0 0 0 0 0 0 0  0 0 0 0 0 0 0 0 0 0 0 0 0 0 0 0 0 0 0 0  
0 0 0 0 0 0 0 0 0 0 0 0 0 0 0 0 0 0 0 0  0 0 0 0 0 0 0 0 0 0 0 0 0 0 0 0 0 0 0 0  
0 0 0 0 0 0 0 0 0 0 0 0 0 0 0 0 0 0 0 0  0 0 0 0 0 0 0 0 0 0 0 0 0 0 0 0 0 0 0 0  
8 0 0 0 0 0 0 8 8 8 0 0 0 0 0 0 0 0 0 0  0 0 0 0 0 0 0 0 0 0 0 0 0 0 0 0 0 0 0 0  
3 8 0 0 0 0 0 0 0 0 0 0 0 0 0 0 0 0 0 0  0 0 0 0 0 0 0 0 0 0 0 0 0 0 0 0 0 0 0 0  
3 3 8 0 0 0 0 0 0 0 0 0 0 0 2 0 0 0 0 0  0 0 0 0 0 0 0 0 0 0 0 0 0 0 0 0 0 0 0 0  
3 3 3 8 0 0 0 0 0 0 0 0 0 0 1 2 2 2 2 0  0 0 0 0 2 2 0 0 0 0 0 0 0 0 0 0 0 0 0 0    
3 3 3 3 8 0 0 0 0 0 0 0 2 2 1 1 1 1 1 0  0 0 0 0 1 1 2 4 4 4 4 4 4 4 4 4 4 4 4 4  
2 2 2 2 2 2 2 2 2 2 0 0 1 1 1 1 1 1 1 0  0 0 0 0 1 1 1 6 0 0 6 0 0 6 0 0 6 0 0 6  
1 1 1 1 1 1 1 1 1 1 2 2 1 1 1 1 1 1 1 2  2 2 2 2 1 1 1 1 0 0 0 0 0 0 0 0 0 0 0 1  

2
 0 0 0 0 0 0 0 0 0 0 0 0 0 0 0 0 0 0 0 0  0 0 0 0 0 0 0 0 0 0 0 0 0 0 0 0 0 0 0 0
 0 0 0 0 0 0 0 0 0 0 0 0 0 0 0 0 0 0 0 0  0 0 0 0 0 0 0 0 0 0 0 0 0 0 0 0 0 4 0 0
 0 0 0 0 0 0 0 0 0 0 0 0 0 0 0 4 0 0 0 0  0 0 0 0 0 0 0 4 0 4 0 0 0 4 0 0 0 0 0 0
 0 0 0 0 0 0 0 0 0 0 0 0 0 0 4 4 4 0 0 0  4 4 4 0 0 0 0 0 4 0 0 0 0 0 0 0 0 0 0 0
 0 0 0 0 0 0 0 0 0 0 0 0 0 0 0 4 0 0 0 0  0 0 0 0 0 0 0 4 0 4 0 0 0 4 0 0 0 0 0 0
 0 0 0 0 0 0 0 0 0 0 0 0 0 0 0 0 0 0 0 0  0 0 0 0 0 0 0 0 0 0 0 0 0 0 0 0 0 2 2 2  
 0 0 0 0 0 0 0 0 4 0 0 0 0 0 0 0 0 0 0 0  0 0 0 0 0 0 0 0 0 0 0 0 0 0 0 0 0 1 1 1
 4 0 0 0 0 0 0 4 4 4 0 0 0 0 0 0 0 0 0 0  0 0 0 0 0 0 0 0 0 0 0 0 0 0 0 0 2 1 1 1 
 2 0 0 0 0 0 0 4 4 4 4 0 0 0 0 0 0 0 0 0  0 0 0 0 0 0 0 0 0 0 0 0 0 0 0 0 1 1 1 1
 1 2 2 2 2 2 0 2 2 2 2 2 2 2 2 2 2 2 0 0  8 8 8 8 8 8 8 8 8 8 8 8 2 2 2 2 1 1 1 1

3
 0 0 0 0 0 0 0 0 0 0 0 0 0 0 0 0 0 0 0 0  0 0 0 0 0 0 0 0 0 0 0 0 0 0 0 0 0 0 0 0 
 0 0 0 0 0 0 0 0 0 0 0 0 0 0 0 0 0 0 0 0  0 0 0 0 0 0 0 0 0 0 0 0 0 0 0 0 0 0 0 0 
 0 0 0 0 0 0 0 0 0 0 0 0 0 0 0 0 0 0 0 0  0 0 0 0 0 0 0 0 0 0 0 0 0 0 0 0 0 0 0 0
 0 0 8 8 0 0 0 0 0 0 0 0 0 0 0 0 0 0 0 0  0 0 0 0 0 0 0 0 0 0 0 0 0 0 0 0 0 0 0 2
 0 0 0 0 0 0 0 0 0 0 0 0 0 0 0 0 0 0 0 0  0 0 0 0 0 0 0 0 0 0 0 0 0 0 0 4 0 0 0 1
 0 0 0 0 0 0 8 8 0 0 0 0 0 0 0 0 0 0 0 0  0 0 0 0 0 0 4 0 0 0 0 0 4 0 0 4 0 0 0 1
 0 0 0 0 0 0 0 0 0 0 0 8 8 0 0 0 0 8 0 8  0 8 0 0 0 0 4 0 0 0 0 0 4 9 4 0 4 0 0 1
 0 0 0 0 0 0 0 0 0 0 0 0 0 0 0 0 8 8 8 8  8 8 8 4 0 0 4 0 0 4 0 0 4 9 9 4 9 0 0 1
 9 9 9 9 9 9 9 9 9 9 9 9 9 9 9 9 0 0 0 0  0 0 4 0 4 0 4 0 4 0 4 4 4 9 9 4 9 0 0 1 
 2 2 2 2 2 2 2 2 2 2 2 2 2 2 2 2 2 2 2 2  0 0 0 4 0 0 4 0 0 4 4 4 4 4 4 4 4 4 4 1

4
 0 0 0 0 0 0 4 8 4 8 4 8 4 8 4 8 4 8 4 0  0 0 0 0 0 0 0 0 0 0 0 0 0 0 0 0 0 0 0 0
 0 0 0 0 0 0 0 8 0 8 0 8 0 8 0 8 0 8 0 0  0 0 0 0 0 0 0 0 0 0 0 0 0 0 0 0 0 0 0 0
 0 0 0 0 0 0 0 8 0 8 0 8 0 8 0 8 0 8 0 0  0 0 0 0 0 0 0 0 0 0 0 0 0 0 0 0 0 0 0 0
 0 0 0 0 0 0 0 0 0 0 0 0 0 0 0 0 0 0 0 0  0 0 0 0 0 0 0 0 0 0 0 0 0 0 0 0 0 0 0 0
 2 0 0 0 0 0 0 0 0 0 0 0 0 0 0 0 0 0 0 0  0 0 0 0 0 0 0 0 0 0 0 0 0 0 0 0 0 0 0 0
 1 0 0 0 0 0 0 0 0 0 0 0 0 0 0 0 0 0 0 0  0 0 0 0 0 0 0 0 0 0 0 0 0 0 0 0 0 0 0 0
 1 0 0 0 0 0 0 0 0 0 0 0 0 0 0 0 0 0 0 0  0 0 0 0 0 0 0 0 0 2 2 2 0 0 0 0 0 0 0 0
 1 0 0 2 2 0 0 0 0 0 0 0 0 0 0 2 2 2 0 0  0 0 0 0 2 2 0 0 2 1 1 1 2 0 0 0 0 0 0 2
 1 0 0 1 1 2 0 0 0 0 0 0 2 2 2 1 1 1 0 0  0 0 0 0 1 1 2 0 1 1 1 1 1 2 0 0 0 2 2 1 
 1 0 0 1 1 1 2 2 2 2 2 2 1 1 1 1 1 1 0 0  2 0 2 2 1 1 1 2 1 1 1 1 1 1 2 2 2 1 1 1

5
 0 0 0 0 0 0 0 0 0 0 0 0 0 0 0 0 0 0 0 0  0 0 0 0 0 0 0 0 0 0 0 0 0 0 0 0 0 0 0 0
 0 0 0 0 0 0 0 0 0 0 0 0 0 0 0 0 0 0 0 0  0 0 0 0 0 0 0 0 0 0 0 0 0 0 4 0 0 0 0 0
 0 0 0 0 0 0 0 0 0 0 0 0 0 0 0 0 0 0 0 0  0 0 0 0 0 0 0 0 0 0 0 0 0 0 0 0 0 0 0 0 
 0 0 0 0 0 0 0 0 0 0 0 0 0 0 0 0 0 0 0 0  0 0 0 0 0 0 0 0 0 0 0 0 4 0 0 0 0 0 0 0
 0 0 0 0 0 0 0 0 0 0 0 0 0 0 0 0 4 0 0 0  0 0 0 0 0 0 0 0 4 0 0 0 0 0 0 0 0 4 4 4
 0 0 0 0 0 0 0 0 0 0 0 0 0 0 0 4 0 4 0 0  0 0 0 0 0 0 0 0 0 0 0 0 0 0 0 0 0 0 0 0
 0 0 0 0 0 0 0 0 0 0 0 0 0 0 0 0 4 0 0 0  0 0 7 7 7 0 0 0 0 0 0 0 0 0 0 0 0 0 0 0
 2 2 2 0 0 0 0 0 0 0 0 2 2 2 0 0 0 2 2 0  0 7 1 1 1 7 9 9 0 0 0 0 7 7 7 7 7 0 0 0
 1 1 1 2 0 0 0 2 2 2 2 1 1 1 0 0 0 1 1 2  0 1 1 1 1 1 1 9 9 9 7 7 1 1 1 1 1 0 0 0
 1 1 1 1 2 2 2 1 1 1 1 1 1 1 0 0 0 1 1 1  7 1 1 1 1 1 1 7 7 7 1 1 1 1 1 1 1 0 0 0

6 
 0 0 0 0 0 0 0 0 0 0 0 0 0 0 0 0 0 0 0 0  0 0 0 0 0 0 0 0 0 0 0 0 0 0 0 0 0 0 0 0
 0 0 0 0 0 0 0 0 0 0 0 0 0 0 0 0 0 0 0 0  0 0 0 0 0 0 0 0 0 0 0 0 0 0 0 0 0 0 0 0 
 0 0 0 0 0 0 0 0 0 0 0 0 0 0 0 0 0 0 0 0  0 0 0 0 0 0 0 0 0 0 8 0 0 0 0 0 0 0 0 0
 0 0 0 0 0 0 0 0 0 0 0 0 0 0 0 0 0 0 0 0  0 0 0 0 0 0 0 0 0 0 0 0 0 0 0 0 8 8 8 8
 0 0 0 0 0 0 0 0 0 0 0 0 0 0 0 0 0 0 0 0  0 0 0 0 0 0 0 8 0 0 0 0 0 0 0 8 0 0 0 0
 0 0 0 0 0 0 0 0 0 0 0 0 0 0 0 0 0 0 0 0  0 0 0 0 8 0 0 0 0 0 0 0 8 8 8 0 0 0 0 0
 0 0 0 0 0 0 0 0 7 7 7 0 0 0 0 0 0 0 0 0  0 0 0 0 0 0 0 0 0 0 8 8 9 9 9 9 9 0 0 0
 7 7 7 0 0 0 7 7 1 1 1 7 0 0 0 0 0 0 0 0  0 0 0 0 0 0 0 0 0 0 0 0 9 9 9 9 9 0 0 0
 1 1 1 7 0 7 1 1 1 1 1 1 7 7 7 7 4 4 4 4  4 4 4 4 4 4 4 4 4 4 4 4 9 9 9 9 9 0 0 0
 1 1 1 1 4 1 1 1 1 1 1 1 1 1 1 1 2 2 4 0  0 0 0 0 0 0 0 0 0 0 4 0 9 9 9 9 9 8 8 8 

7 
 0 0 0 0 0 0 0 0 0 0 0 0 0 0 0 0 0 0 0 0  0 0 0 0 0 0 0 0 0 0 0 0 0 0 0 0 0 0 0 0
 0 0 0 0 0 0 0 0 0 0 0 0 0 0 0 0 0 0 0 0  0 0 0 0 0 0 0 0 0 0 0 0 0 0 0 0 0 0 0 0 
 0 0 0 0 0 0 0 0 0 0 0 0 0 0 0 0 0 0 0 0  0 0 0 0 0 0 0 0 0 0 0 0 0 0 0 0 0 0 0 0
 0 0 0 0 0 0 0 0 0 0 0 0 0 0 0 0 0 0 0 0  0 0 0 0 0 0 8 8 8 0 0 0 0 0 0 0 0 0 0 0
 0 0 0 0 0 0 0 0 0 0 0 0 0 0 0 0 0 0 8 0  0 0 0 0 0 0 0 0 0 0 0 0 0 0 0 0 0 0 0 0
 0 0 0 0 0 0 0 0 0 0 0 0 0 0 0 0 0 0 0 0  0 8 8 8 8 0 0 0 0 0 0 0 2 2 2 2 2 2 0 0
 0 0 0 8 8 8 0 0 0 0 0 0 0 8 8 0 0 0 0 0  0 0 0 0 0 0 0 0 0 0 0 0 1 1 1 1 1 1 0 0
 0 0 0 0 0 0 0 0 0 0 0 0 0 0 0 0 0 0 0 9  0 0 0 0 0 0 0 0 0 0 0 2 1 1 1 1 1 1 0 0
 0 0 0 0 0 0 0 0 8 8 8 8 8 0 0 0 0 0 9 0  9 0 0 0 0 0 0 0 0 0 0 1 1 1 1 1 1 1 0 0
 8 8 8 0 0 0 0 0 0 0 0 0 0 0 0 0 9 9 9 9  0 9 0 0 0 0 0 0 0 0 0 1 1 1 1 1 1 1 0 0

8
 0 0 0 0 0 0 0 0 0 0 0 0 0 0 0 0 0 0 0 0  0 0 0 0 0 0 0 0 0 0 0 0 0 0 0 0 0 0 0 0
 0 0 0 0 0 0 0 0 0 0 0 0 0 0 0 0 0 0 0 0  0 0 0 0 0 0 0 0 0 0 0 0 0 0 0 0 0 0 0 0
 0 0 0 0 0 0 0 0 0 0 0 0 0 0 0 0 0 0 0 0  0 0 0 0 0 0 0 0 0 0 0 0 0 0 0 0 0 0 0 0
 0 0 0 0 0 0 0 0 0 0 0 0 0 0 0 0 0 0 0 0  0 0 0 0 0 0 0 0 0 0 0 0 0 4 4 4 4 4 4 4
 0 0 0 0 0 0 0 0 0 0 0 0 2 2 0 0 0 0 0 2  0 0 0 0 0 0 0 0 0 0 0 0 4 4 4 4 4 4 4 4
 0 2 0 0 0 2 0 0 0 2 0 0 0 0 0 0 0 0 2 1  2 0 0 0 0 0 0 0 0 0 0 4 4 4 4 4 4 4 4 4
 0 1 0 0 0 1 0 0 0 1 0 0 0 0 0 0 0 2 1 1  1 2 0 0 0 0 0 0 0 0 4 4 4 4 4 4 4 4 4 4
 0 1 0 0 0 1 0 0 0 1 0 0 0 0 0 0 2 1 1 1  1 1 2 0 0 0 0 0 0 4 4 4 4 4 4 4 4 4 4 4 
 0 1 0 0 0 1 0 0 0 1 0 0 0 0 0 2 1 1 1 1  1 1 1 2 2 2 2 2 2 2 2 2 2 2 2 2 2 2 2 2
 0 1 0 0 0 1 0 0 0 1 0 0 0 0 0 1 1 1 1 1  1 1 1 1 1 1 1 1 1 1 1 1 1 1 1 1 1 1 1 1 
